"Year","Seed1","Score1","Team1","Team2","Score2","Seed2","ScoreDiff","Upset","ID"
2013,1,79,"Louisville","North Carolina A&T",48,16,31,0,"Louisville-North Carolina A&T"
2013,2,73,"Duke","Albany",61,15,12,0,"Duke-Albany"
2013,3,65,"Michigan St.","Valparaiso",54,14,11,0,"Michigan St.-Valparaiso"
2013,4,64,"Saint Louis","New Mexico St.",44,13,20,0,"Saint Louis-New Mexico St."
2013,5,55,"Oklahoma St.","Oregon",68,12,-13,0,"Oklahoma St.-Oregon"
2013,6,54,"Memphis","Saint Mary's",52,11,2,0,"Memphis-Saint Mary's"
2013,7,67,"Creighton","Cincinnati",63,10,4,0,"Creighton-Cincinnati"
2013,8,84,"Colorado St.","Missouri",72,9,12,0,"Colorado St.-Missouri"
2013,1,64,"Gonzaga","Southern",58,16,6,0,"Gonzaga-Southern"
2013,2,95,"Ohio St.","Iona",70,15,25,0,"Ohio St.-Iona"
2013,3,62,"New Mexico","Harvard",68,14,-6,0,"New Mexico-Harvard"
2013,4,61,"Kansas St.","La Salle",63,13,-2,0,"Kansas St.-La Salle"
2013,5,46,"Wisconsin","Mississippi",57,12,-11,0,"Wisconsin-Mississippi"
2013,6,81,"Arizona","Belmont",64,11,17,0,"Arizona-Belmont"
2013,7,58,"Notre Dame","Iowa St.",76,10,-18,0,"Notre Dame-Iowa St."
2013,8,55,"Pittsburgh","Wichita St.",73,9,-18,0,"Pittsburgh-Wichita St."
2013,1,64,"Kansas","Western Kentucky",57,16,7,0,"Kansas-Western Kentucky"
2013,2,68,"Georgetown","Florida Gulf Coast",78,15,-10,0,"Georgetown-Florida Gulf Coast"
2013,3,79,"Florida","Northwestern St.",47,14,32,0,"Florida-Northwestern St."
2013,4,71,"Michigan","South Dakota St.",56,13,15,0,"Michigan-South Dakota St."
2013,5,88,"VCU","Akron",42,12,46,0,"VCU-Akron"
2013,6,63,"UCLA","Minnesota",83,11,-20,0,"UCLA-Minnesota"
2013,7,70,"San Diego St.","Oklahoma",55,10,15,0,"San Diego St.-Oklahoma"
2013,8,78,"North Carolina","Villanova",71,9,7,0,"North Carolina-Villanova"
2013,1,83,"Indiana","James Madison",62,16,21,0,"Indiana-James Madison"
2013,2,78,"Miami FL","Pacific",49,15,29,0,"Miami FL-Pacific"
2013,3,59,"Marquette","Davidson",58,14,1,0,"Marquette-Davidson"
2013,4,81,"Syracuse","Montana",34,13,47,0,"Syracuse-Montana"
2013,5,61,"UNLV","California",64,12,-3,0,"UNLV-California"
2013,6,68,"Butler","Bucknell",56,11,12,0,"Butler-Bucknell"
2013,7,57,"Illinois","Colorado",49,10,8,0,"Illinois-Colorado"
2013,8,72,"North Carolina St.","Temple",76,9,-4,0,"North Carolina St.-Temple"
2013,1,82,"Louisville","Colorado St.",56,8,26,0,"Louisville-Colorado St."
2013,2,66,"Duke","Creighton",50,7,16,0,"Duke-Creighton"
2013,3,70,"Michigan St.","Memphis",48,6,22,0,"Michigan St.-Memphis"
2013,4,57,"Saint Louis","Oregon",74,12,-17,0,"Saint Louis-Oregon"
2013,1,70,"Gonzaga","Wichita St.",76,9,-6,0,"Gonzaga-Wichita St."
2013,2,78,"Ohio St.","Iowa St.",75,10,3,0,"Ohio St.-Iowa St."
2013,14,51,"Harvard","Arizona",74,6,-23,1,"Harvard-Arizona"
2013,13,76,"La Salle","Mississippi",74,12,2,1,"La Salle-Mississippi"
2013,1,70,"Kansas","North Carolina",58,8,12,0,"Kansas-North Carolina"
2013,15,81,"Florida Gulf Coast","San Diego St.",71,7,10,1,"Florida Gulf Coast-San Diego St."
2013,3,78,"Florida","Minnesota",64,11,14,0,"Florida-Minnesota"
2013,4,78,"Michigan","VCU",53,5,25,0,"Michigan-VCU"
2013,1,58,"Indiana","Temple",52,9,6,0,"Indiana-Temple"
2013,2,63,"Miami FL","Illinois",59,7,4,0,"Miami FL-Illinois"
2013,3,74,"Marquette","Butler",72,6,2,0,"Marquette-Butler"
2013,4,66,"Syracuse","California",60,12,6,0,"Syracuse-California"
2013,1,77,"Louisville","Oregon",69,12,8,0,"Louisville-Oregon"
2013,2,71,"Duke","Michigan St.",61,3,10,0,"Duke-Michigan St."
2013,9,72,"Wichita St.","La Salle",58,13,14,0,"Wichita St.-La Salle"
2013,2,73,"Ohio St.","Arizona",70,6,3,0,"Ohio St.-Arizona"
2013,1,85,"Kansas","Michigan",87,4,-2,0,"Kansas-Michigan"
2013,15,50,"Florida Gulf Coast","Florida",62,3,-12,1,"Florida Gulf Coast-Florida"
2013,1,50,"Indiana","Syracuse",61,4,-11,0,"Indiana-Syracuse"
2013,2,61,"Miami FL","Marquette",71,3,-10,0,"Miami FL-Marquette"
2013,1,85,"Louisville","Duke",63,2,22,0,"Louisville-Duke"
2013,9,70,"Wichita St.","Ohio St.",66,2,4,1,"Wichita St.-Ohio St."
2013,4,79,"Michigan","Florida",59,3,20,1,"Michigan-Florida"
2013,4,55,"Syracuse","Marquette",39,3,16,1,"Syracuse-Marquette"
2013,1,72,"Louisville","Wichita St.",68,9,4,0,"Louisville-Wichita St."
2013,4,61,"Michigan","Syracuse",56,4,5,0,"Michigan-Syracuse"
2013,1,82,"Louisville","Michigan",76,4,6,0,"Louisville-Michigan"
2014,1,67,"Florida","Albany",55,16,12,0,"Florida-Albany"
2014,2,80,"Kansas","Eastern Kentucky",69,15,11,0,"Kansas-Eastern Kentucky"
2014,3,77,"Syracuse","Western Michigan",53,14,24,0,"Syracuse-Western Michigan"
2014,4,76,"UCLA","Tulsa",59,13,17,0,"UCLA-Tulsa"
2014,5,75,"VCU","Stephen F. Austin",77,12,-2,0,"VCU-Stephen F. Austin"
2014,6,59,"Ohio St.","Dayton",60,11,-1,0,"Ohio St.-Dayton"
2014,7,53,"New Mexico","Stanford",58,10,-5,0,"New Mexico-Stanford"
2014,8,48,"Colorado","Pittsburgh",77,9,-29,0,"Colorado-Pittsburgh"
2014,1,70,"Virginia","Coastal Carolina",59,16,11,0,"Virginia-Coastal Carolina"
2014,2,73,"Villanova","Milwaukee",53,15,20,0,"Villanova-Milwaukee"
2014,3,93,"Iowa St.","North Carolina Central",75,14,18,0,"Iowa St.-North Carolina Central"
2014,4,93,"Michigan St.","Delaware",78,13,15,0,"Michigan St.-Delaware"
2014,5,57,"Cincinnati","Harvard",61,12,-4,0,"Cincinnati-Harvard"
2014,6,79,"North Carolina","Providence",77,11,2,0,"North Carolina-Providence"
2014,7,89,"Connecticut","Saint Joseph's",81,10,8,0,"Connecticut-Saint Joseph's"
2014,8,71,"Memphis","George Washington",66,9,5,0,"Memphis-George Washington"
2014,1,88,"Arizona","Weber St.",59,16,29,0,"Arizona-Weber St."
2014,2,75,"Wisconsin","American",35,15,40,0,"Wisconsin-American"
2014,3,76,"Creighton","Louisiana Lafayette",66,14,10,0,"Creighton-Louisiana Lafayette"
2014,4,73,"San Diego St.","New Mexico St.",69,13,4,0,"San Diego St.-New Mexico St."
2014,5,75,"Oklahoma","North Dakota St.",80,12,-5,0,"Oklahoma-North Dakota St."
2014,6,74,"Baylor","Nebraska",60,11,14,0,"Baylor-Nebraska"
2014,7,87,"Oregon","BYU",68,10,19,0,"Oregon-BYU"
2014,8,85,"Gonzaga","Oklahoma St.",77,9,8,0,"Gonzaga-Oklahoma St."
2014,1,64,"Wichita St.","Cal Poly",37,16,27,0,"Wichita St.-Cal Poly"
2014,2,57,"Michigan","Wofford",40,15,17,0,"Michigan-Wofford"
2014,3,71,"Duke","Mercer",78,14,-7,0,"Duke-Mercer"
2014,4,71,"Louisville","Manhattan",64,13,7,0,"Louisville-Manhattan"
2014,5,83,"Saint Louis","North Carolina St.",80,12,3,0,"Saint Louis-North Carolina St."
2014,6,67,"Massachusetts","Tennessee",86,11,-19,0,"Massachusetts-Tennessee"
2014,7,87,"Texas","Arizona St.",85,10,2,0,"Texas-Arizona St."
2014,8,56,"Kentucky","Kansas St.",49,9,7,0,"Kentucky-Kansas St."
2014,1,61,"Florida","Pittsburgh",45,9,16,0,"Florida-Pittsburgh"
2014,2,57,"Kansas","Stanford",60,10,-3,0,"Kansas-Stanford"
2014,3,53,"Syracuse","Dayton",55,11,-2,0,"Syracuse-Dayton"
2014,4,77,"UCLA","Stephen F. Austin",60,12,17,0,"UCLA-Stephen F. Austin"
2014,1,78,"Virginia","Memphis",60,8,18,0,"Virginia-Memphis"
2014,2,65,"Villanova","Connecticut",77,7,-12,0,"Villanova-Connecticut"
2014,3,85,"Iowa St.","North Carolina",83,6,2,0,"Iowa St.-North Carolina"
2014,4,80,"Michigan St.","Harvard",73,12,7,0,"Michigan St.-Harvard"
2014,1,84,"Arizona","Gonzaga",81,8,3,0,"Arizona-Gonzaga"
2014,2,85,"Wisconsin","Oregon",77,7,8,0,"Wisconsin-Oregon"
2014,3,55,"Creighton","Baylor",85,6,-30,0,"Creighton-Baylor"
2014,4,63,"San Diego St.","North Dakota St.",44,12,19,0,"San Diego St.-North Dakota St."
2014,1,76,"Wichita St.","Kentucky",78,8,-2,0,"Wichita St.-Kentucky"
2014,2,79,"Michigan","Texas",65,7,14,0,"Michigan-Texas"
2014,14,63,"Mercer","Tennessee",83,11,-20,1,"Mercer-Tennessee"
2014,4,66,"Louisville","Saint Louis",51,5,15,0,"Louisville-Saint Louis"
2014,1,79,"Florida","UCLA",68,4,11,0,"Florida-UCLA"
2014,10,72,"Stanford","Dayton",82,11,-10,0,"Stanford-Dayton"
2014,1,59,"Virginia","Michigan St.",61,4,-2,0,"Virginia-Michigan St."
2014,7,81,"Connecticut","Iowa St.",76,3,5,1,"Connecticut-Iowa St."
2014,1,70,"Arizona","San Diego St.",64,4,6,0,"Arizona-San Diego St."
2014,2,69,"Wisconsin","Baylor",52,6,17,0,"Wisconsin-Baylor"
2014,8,74,"Kentucky","Louisville",69,4,5,1,"Kentucky-Louisville"
2014,2,73,"Michigan","Tennessee",71,11,2,0,"Michigan-Tennessee"
2014,1,62,"Florida","Dayton",52,11,10,0,"Florida-Dayton"
2014,4,54,"Michigan St.","Connecticut",60,7,-6,0,"Michigan St.-Connecticut"
2014,1,63,"Arizona","Wisconsin",64,2,-1,0,"Arizona-Wisconsin"
2014,8,75,"Kentucky","Michigan",72,2,3,1,"Kentucky-Michigan"
2014,1,53,"Florida","Connecticut",63,7,-10,0,"Florida-Connecticut"
2014,2,73,"Wisconsin","Kentucky",74,8,-1,0,"Wisconsin-Kentucky"
2014,7,60,"Connecticut","Kentucky",54,8,6,0,"Connecticut-Kentucky"
2015,1,79,"Kentucky","Hampton",56,16,23,0,"Kentucky-Hampton"
2015,2,75,"Kansas","New Mexico St.",56,15,19,0,"Kansas-New Mexico St."
2015,3,69,"Notre Dame","Northeastern",65,14,4,0,"Notre Dame-Northeastern"
2015,4,65,"Maryland","Valparaiso",62,13,3,0,"Maryland-Valparaiso"
2015,5,68,"West Virginia","Buffalo",62,12,6,0,"West Virginia-Buffalo"
2015,6,56,"Butler","Texas",48,11,8,0,"Butler-Texas"
2015,7,81,"Wichita St.","Indiana",76,10,5,0,"Wichita St.-Indiana"
2015,8,66,"Cincinnati","Purdue",65,9,1,0,"Cincinnati-Purdue"
2015,1,86,"Wisconsin","Coastal Carolina",72,16,14,0,"Wisconsin-Coastal Carolina"
2015,2,93,"Arizona","Texas Southern",72,15,21,0,"Arizona-Texas Southern"
2015,3,56,"Baylor","Georgia St.",57,14,-1,0,"Baylor-Georgia St."
2015,4,67,"North Carolina","Harvard",65,13,2,0,"North Carolina-Harvard"
2015,5,56,"Arkansas","Wofford",53,12,3,0,"Arkansas-Wofford"
2015,6,76,"Xavier","Mississippi",57,11,19,0,"Xavier-Mississippi"
2015,7,72,"VCU","Ohio St.",75,10,-3,0,"VCU-Ohio St."
2015,8,79,"Oregon","Oklahoma St.",73,9,6,0,"Oregon-Oklahoma St."
2015,1,93,"Villanova","Lafayette",52,16,41,0,"Villanova-Lafayette"
2015,2,79,"Virginia","Belmont",67,15,12,0,"Virginia-Belmont"
2015,3,69,"Oklahoma","Albany",60,14,9,0,"Oklahoma-Albany"
2015,4,57,"Louisville","UC Irvine",55,13,2,0,"Louisville-UC Irvine"
2015,5,71,"Northern Iowa","Wyoming",54,12,17,0,"Northern Iowa-Wyoming"
2015,6,53,"Providence","Dayton",66,11,-13,0,"Providence-Dayton"
2015,7,70,"Michigan St.","Georgia",63,10,7,0,"Michigan St.-Georgia"
2015,8,66,"North Carolina St.","LSU",65,9,1,0,"North Carolina St.-LSU"
2015,1,85,"Duke","Robert Morris",56,16,29,0,"Duke-Robert Morris"
2015,2,86,"Gonzaga","North Dakota St.",76,15,10,0,"Gonzaga-North Dakota St."
2015,3,59,"Iowa St.","UAB",60,14,-1,0,"Iowa St.-UAB"
2015,4,84,"Georgetown","Eastern Washington",74,13,10,0,"Georgetown-Eastern Washington"
2015,5,57,"Utah","Stephen F. Austin",50,12,7,0,"Utah-Stephen F. Austin"
2015,6,59,"SMU","UCLA",60,11,-1,0,"SMU-UCLA"
2015,7,83,"Iowa","Davidson",52,10,31,0,"Iowa-Davidson"
2015,8,76,"San Diego St.","St. John's",64,9,12,0,"San Diego St.-St. John's"
2015,1,64,"Kentucky","Cincinnati",51,8,13,0,"Kentucky-Cincinnati"
2015,2,65,"Kansas","Wichita St.",78,7,-13,0,"Kansas-Wichita St."
2015,3,67,"Notre Dame","Butler",64,6,3,0,"Notre Dame-Butler"
2015,4,59,"Maryland","West Virginia",69,5,-10,0,"Maryland-West Virginia"
2015,1,72,"Wisconsin","Oregon",65,8,7,0,"Wisconsin-Oregon"
2015,2,73,"Arizona","Ohio St.",58,10,15,0,"Arizona-Ohio St."
2015,14,67,"Georgia St.","Xavier",75,6,-8,1,"Georgia St.-Xavier"
2015,4,87,"North Carolina","Arkansas",78,5,9,0,"North Carolina-Arkansas"
2015,1,68,"Villanova","North Carolina St.",71,8,-3,0,"Villanova-North Carolina St."
2015,2,54,"Virginia","Michigan St.",60,7,-6,0,"Virginia-Michigan St."
2015,3,72,"Oklahoma","Dayton",66,11,6,0,"Oklahoma-Dayton"
2015,4,66,"Louisville","Northern Iowa",53,5,13,0,"Louisville-Northern Iowa"
2015,1,68,"Duke","San Diego St.",49,8,19,0,"Duke-San Diego St."
2015,2,87,"Gonzaga","Iowa",68,7,19,0,"Gonzaga-Iowa"
2015,14,75,"UAB","UCLA",92,11,-17,1,"UAB-UCLA"
2015,4,64,"Georgetown","Utah",75,5,-11,0,"Georgetown-Utah"
2015,1,78,"Kentucky","West Virginia",39,5,39,0,"Kentucky-West Virginia"
2015,7,70,"Wichita St.","Notre Dame",81,3,-11,1,"Wichita St.-Notre Dame"
2015,1,79,"Wisconsin","North Carolina",72,4,7,0,"Wisconsin-North Carolina"
2015,2,68,"Arizona","Xavier",60,6,8,0,"Arizona-Xavier"
2015,8,65,"North Carolina St.","Louisville",75,4,-10,1,"North Carolina St.-Louisville"
2015,7,62,"Michigan St.","Oklahoma",58,3,4,1,"Michigan St.-Oklahoma"
2015,1,63,"Duke","Utah",57,5,6,0,"Duke-Utah"
2015,2,74,"Gonzaga","UCLA",62,11,12,0,"Gonzaga-UCLA"
2015,1,68,"Kentucky","Notre Dame",66,3,2,0,"Kentucky-Notre Dame"
2015,1,85,"Wisconsin","Arizona",78,2,7,0,"Wisconsin-Arizona"
2015,4,70,"Louisville","Michigan St.",76,7,-6,0,"Louisville-Michigan St."
2015,1,66,"Duke","Gonzaga",52,2,14,0,"Duke-Gonzaga"
2015,1,64,"Kentucky","Wisconsin",71,1,-7,0,"Kentucky-Wisconsin"
2015,7,61,"Michigan St.","Duke",81,1,-20,1,"Michigan St.-Duke"
2015,1,63,"Wisconsin","Duke",68,1,-5,0,"Wisconsin-Duke"
2016,1,105,"Kansas","Austin Peay",79,16,26,0,"Kansas-Austin Peay"
2016,2,86,"Villanova","UNC Asheville",56,15,30,0,"Villanova-UNC Asheville"
2016,3,79,"Miami FL","Buffalo",72,14,7,0,"Miami FL-Buffalo"
2016,4,66,"California","Hawaii",77,13,-11,0,"California-Hawaii"
2016,5,79,"Maryland","South Dakota St.",74,12,5,0,"Maryland-South Dakota St."
2016,6,55,"Arizona","Wichita St.",65,11,-10,0,"Arizona-Wichita St."
2016,7,72,"Iowa","Temple",70,10,2,0,"Iowa-Temple"
2016,8,67,"Colorado","Connecticut",74,9,-7,0,"Colorado-Connecticut"
2016,1,91,"Oregon","Holy Cross",52,16,39,0,"Oregon-Holy Cross"
2016,2,82,"Oklahoma","Cal St. Bakersfield",68,15,14,0,"Oklahoma-Cal St. Bakersfield"
2016,3,92,"Texas A&M","Green Bay",65,14,27,0,"Texas A&M-Green Bay"
2016,4,93,"Duke","UNC Wilmington",85,13,8,0,"Duke-UNC Wilmington"
2016,5,75,"Baylor","Yale",79,12,-4,0,"Baylor-Yale"
2016,6,72,"Texas","Northern Iowa",75,11,-3,0,"Texas-Northern Iowa"
2016,7,67,"Oregon St.","VCU",75,10,-8,0,"Oregon St.-VCU"
2016,8,78,"Saint Joseph's","Cincinnati",76,9,2,0,"Saint Joseph's-Cincinnati"
2016,1,83,"North Carolina","Florida Gulf Coast",67,16,16,0,"North Carolina-Florida Gulf Coast"
2016,2,71,"Xavier","Weber St.",53,15,18,0,"Xavier-Weber St."
2016,3,56,"West Virginia","Stephen F. Austin",70,14,-14,0,"West Virginia-Stephen F. Austin"
2016,4,85,"Kentucky","Stony Brook",57,13,28,0,"Kentucky-Stony Brook"
2016,5,99,"Indiana","Chattanooga",74,12,25,0,"Indiana-Chattanooga"
2016,6,70,"Notre Dame","Michigan",63,11,7,0,"Notre Dame-Michigan"
2016,7,47,"Wisconsin","Pittsburgh",43,10,4,0,"Wisconsin-Pittsburgh"
2016,8,69,"USC","Providence",70,9,-1,0,"USC-Providence"
2016,1,81,"Virginia","Hampton",45,16,36,0,"Virginia-Hampton"
2016,2,81,"Michigan St.","Middle Tennessee",90,15,-9,0,"Michigan St.-Middle Tennessee"
2016,3,80,"Utah","Fresno St.",69,14,11,0,"Utah-Fresno St."
2016,4,94,"Iowa St.","Iona",81,13,13,0,"Iowa St.-Iona"
2016,5,83,"Purdue","Arkansas Little Rock",85,12,-2,0,"Purdue-Arkansas Little Rock"
2016,6,52,"Seton Hall","Gonzaga",68,11,-16,0,"Seton Hall-Gonzaga"
2016,7,51,"Dayton","Syracuse",70,10,-19,0,"Dayton-Syracuse"
2016,8,61,"Texas Tech","Butler",71,9,-10,0,"Texas Tech-Butler"
2016,1,73,"Kansas","Connecticut",61,9,12,0,"Kansas-Connecticut"
2016,2,87,"Villanova","Iowa",68,7,19,0,"Villanova-Iowa"
2016,3,65,"Miami FL","Wichita St.",57,11,8,0,"Miami FL-Wichita St."
2016,13,60,"Hawaii","Maryland",73,5,-13,1,"Hawaii-Maryland"
2016,1,69,"Oregon","Saint Joseph's",64,8,5,0,"Oregon-Saint Joseph's"
2016,2,85,"Oklahoma","VCU",81,10,4,0,"Oklahoma-VCU"
2016,3,92,"Texas A&M","Northern Iowa",88,11,4,0,"Texas A&M-Northern Iowa"
2016,4,71,"Duke","Yale",64,12,7,0,"Duke-Yale"
2016,1,85,"North Carolina","Providence",66,9,19,0,"North Carolina-Providence"
2016,2,63,"Xavier","Wisconsin",66,7,-3,0,"Xavier-Wisconsin"
2016,14,75,"Stephen F. Austin","Notre Dame",76,6,-1,1,"Stephen F. Austin-Notre Dame"
2016,4,67,"Kentucky","Indiana",73,5,-6,0,"Kentucky-Indiana"
2016,1,77,"Virginia","Butler",69,9,8,0,"Virginia-Butler"
2016,15,50,"Middle Tennessee","Syracuse",75,10,-25,1,"Middle Tennessee-Syracuse"
2016,3,59,"Utah","Gonzaga",82,11,-23,0,"Utah-Gonzaga"
2016,4,78,"Iowa St.","Arkansas Little Rock",61,12,17,0,"Iowa St.-Arkansas Little Rock"
2016,1,79,"Kansas","Maryland",63,5,16,0,"Kansas-Maryland"
2016,2,92,"Villanova","Miami FL",69,3,23,0,"Villanova-Miami FL"
2016,1,82,"Oregon","Duke",68,4,14,0,"Oregon-Duke"
2016,2,77,"Oklahoma","Texas A&M",63,3,14,0,"Oklahoma-Texas A&M"
2016,1,101,"North Carolina","Indiana",86,5,15,0,"North Carolina-Indiana"
2016,7,56,"Wisconsin","Notre Dame",61,6,-5,1,"Wisconsin-Notre Dame"
2016,1,84,"Virginia","Iowa St.",71,4,13,0,"Virginia-Iowa St."
2016,10,63,"Syracuse","Gonzaga",60,11,3,0,"Syracuse-Gonzaga"
2016,1,59,"Kansas","Villanova",64,2,-5,0,"Kansas-Villanova"
2016,1,68,"Oregon","Oklahoma",80,2,-12,0,"Oregon-Oklahoma"
2016,1,88,"North Carolina","Notre Dame",74,6,14,0,"North Carolina-Notre Dame"
2016,1,62,"Virginia","Syracuse",68,10,-6,0,"Virginia-Syracuse"
2016,2,95,"Villanova","Oklahoma",51,2,44,0,"Villanova-Oklahoma"
2016,1,83,"North Carolina","Syracuse",66,10,17,0,"North Carolina-Syracuse"
2016,2,77,"Villanova","North Carolina",74,1,3,1,"Villanova-North Carolina"
2017,1,76,"Villanova","Mount St. Mary's",56,16,20,0,"Villanova-Mount St. Mary's"
2017,2,87,"Duke","Troy",65,15,22,0,"Duke-Troy"
2017,3,91,"Baylor","New Mexico St.",73,14,18,0,"Baylor-New Mexico St."
2017,4,80,"Florida","East Tennessee St.",65,13,15,0,"Florida-East Tennessee St."
2017,5,76,"Virginia","UNC Wilmington",71,12,5,0,"Virginia-UNC Wilmington"
2017,6,65,"SMU","USC",66,11,-1,0,"SMU-USC"
2017,7,93,"South Carolina","Marquette",73,10,20,0,"South Carolina-Marquette"
2017,8,84,"Wisconsin","Virginia Tech",74,9,10,0,"Wisconsin-Virginia Tech"
2017,1,66,"Gonzaga","South Dakota St.",46,16,20,0,"Gonzaga-South Dakota St."
2017,2,100,"Arizona","North Dakota",82,15,18,0,"Arizona-North Dakota"
2017,3,86,"Florida St.","Florida Gulf Coast",80,14,6,0,"Florida St.-Florida Gulf Coast"
2017,4,86,"West Virginia","Bucknell",80,13,6,0,"West Virginia-Bucknell"
2017,5,60,"Notre Dame","Princeton",58,12,2,0,"Notre Dame-Princeton"
2017,6,65,"Maryland","Xavier",76,11,-11,0,"Maryland-Xavier"
2017,7,85,"Saint Mary's","VCU",77,10,8,0,"Saint Mary's-VCU"
2017,8,68,"Northwestern","Vanderbilt",66,9,2,0,"Northwestern-Vanderbilt"
2017,1,100,"Kansas","UC Davis",62,16,38,0,"Kansas-UC Davis"
2017,2,78,"Louisville","Jacksonville St.",63,15,15,0,"Louisville-Jacksonville St."
2017,3,93,"Oregon","Iona",77,14,16,0,"Oregon-Iona"
2017,4,80,"Purdue","Vermont",70,13,10,0,"Purdue-Vermont"
2017,5,84,"Iowa St.","Nevada",73,12,11,0,"Iowa St.-Nevada"
2017,6,72,"Creighton","Rhode Island",84,11,-12,0,"Creighton-Rhode Island"
2017,7,92,"Michigan","Oklahoma St.",91,10,1,0,"Michigan-Oklahoma St."
2017,8,58,"Miami FL","Michigan St.",78,9,-20,0,"Miami FL-Michigan St."
2017,1,103,"North Carolina","Texas Southern",64,16,39,0,"North Carolina-Texas Southern"
2017,2,79,"Kentucky","Northern Kentucky",70,15,9,0,"Kentucky-Northern Kentucky"
2017,3,97,"UCLA","Kent St.",80,14,17,0,"UCLA-Kent St."
2017,4,76,"Butler","Winthrop",64,13,12,0,"Butler-Winthrop"
2017,5,72,"Minnesota","Middle Tennessee",81,12,-9,0,"Minnesota-Middle Tennessee"
2017,6,75,"Cincinnati","Kansas St.",61,11,14,0,"Cincinnati-Kansas St."
2017,7,58,"Dayton","Wichita St.",64,10,-6,0,"Dayton-Wichita St."
2017,8,77,"Arkansas","Seton Hall",71,9,6,0,"Arkansas-Seton Hall"
2017,1,62,"Villanova","Wisconsin",65,8,-3,0,"Villanova-Wisconsin"
2017,2,81,"Duke","South Carolina",88,7,-7,0,"Duke-South Carolina"
2017,3,82,"Baylor","USC",78,11,4,0,"Baylor-USC"
2017,4,65,"Florida","Virginia",39,5,26,0,"Florida-Virginia"
2017,1,79,"Gonzaga","Northwestern",73,8,6,0,"Gonzaga-Northwestern"
2017,2,69,"Arizona","Saint Mary's",60,7,9,0,"Arizona-Saint Mary's"
2017,3,66,"Florida St.","Xavier",91,11,-25,0,"Florida St.-Xavier"
2017,4,83,"West Virginia","Notre Dame",71,5,12,0,"West Virginia-Notre Dame"
2017,1,90,"Kansas","Michigan St.",70,9,20,0,"Kansas-Michigan St."
2017,2,69,"Louisville","Michigan",73,7,-4,0,"Louisville-Michigan"
2017,3,75,"Oregon","Rhode Island",72,11,3,0,"Oregon-Rhode Island"
2017,4,80,"Purdue","Iowa St.",76,5,4,0,"Purdue-Iowa St."
2017,1,72,"North Carolina","Arkansas",65,8,7,0,"North Carolina-Arkansas"
2017,2,65,"Kentucky","Wichita St.",62,10,3,0,"Kentucky-Wichita St."
2017,3,79,"UCLA","Cincinnati",67,6,12,0,"UCLA-Cincinnati"
2017,4,74,"Butler","Middle Tennessee",65,12,9,0,"Butler-Middle Tennessee"
2017,8,83,"Wisconsin","Florida",84,4,-1,1,"Wisconsin-Florida"
2017,7,70,"South Carolina","Baylor",50,3,20,1,"South Carolina-Baylor"
2017,1,61,"Gonzaga","West Virginia",58,4,3,0,"Gonzaga-West Virginia"
2017,2,71,"Arizona","Xavier",73,11,-2,0,"Arizona-Xavier"
2017,1,98,"Kansas","Purdue",66,4,32,0,"Kansas-Purdue"
2017,7,68,"Michigan","Oregon",69,3,-1,1,"Michigan-Oregon"
2017,1,92,"North Carolina","Butler",80,4,12,0,"North Carolina-Butler"
2017,2,86,"Kentucky","UCLA",75,3,11,0,"Kentucky-UCLA"
2017,4,70,"Florida","South Carolina",77,7,-7,0,"Florida-South Carolina"
2017,1,83,"Gonzaga","Xavier",59,11,24,0,"Gonzaga-Xavier"
2017,1,60,"Kansas","Oregon",74,3,-14,0,"Kansas-Oregon"
2017,1,75,"North Carolina","Kentucky",73,2,2,0,"North Carolina-Kentucky"
2017,7,73,"South Carolina","Gonzaga",77,1,-4,1,"South Carolina-Gonzaga"
2017,3,76,"Oregon","North Carolina",77,1,-1,1,"Oregon-North Carolina"
2017,1,65,"Gonzaga","North Carolina",71,1,-6,0,"Gonzaga-North Carolina"
2018,1,54,"Virginia","UMBC",74,16,-20,0,"Virginia-UMBC"
2018,2,68,"Cincinnati","Georgia St.",53,15,15,0,"Cincinnati-Georgia St."
2018,3,73,"Tennessee","Wright St.",47,14,26,0,"Tennessee-Wright St."
2018,4,68,"Arizona","Buffalo",89,13,-21,0,"Arizona-Buffalo"
2018,5,78,"Kentucky","Davidson",73,12,5,0,"Kentucky-Davidson"
2018,6,62,"Miami FL","Loyola Chicago",64,11,-2,0,"Miami FL-Loyola Chicago"
2018,7,87,"Nevada","Texas",83,10,4,0,"Nevada-Texas"
2018,8,59,"Creighton","Kansas St.",69,9,-10,0,"Creighton-Kansas St."
2018,1,102,"Xavier","Texas Southern",83,16,19,0,"Xavier-Texas Southern"
2018,2,84,"North Carolina","Lipscomb",66,15,18,0,"North Carolina-Lipscomb"
2018,3,61,"Michigan","Montana",47,14,14,0,"Michigan-Montana"
2018,4,68,"Gonzaga","UNC Greensboro",64,13,4,0,"Gonzaga-UNC Greensboro"
2018,5,81,"Ohio St.","South Dakota St.",73,12,8,0,"Ohio St.-South Dakota St."
2018,6,67,"Houston","San Diego St.",65,11,2,0,"Houston-San Diego St."
2018,7,73,"Texas A&M","Providence",69,10,4,0,"Texas A&M-Providence"
2018,8,54,"Missouri","Florida St.",67,9,-13,0,"Missouri-Florida St."
2018,1,87,"Villanova","Radford",61,16,26,0,"Villanova-Radford"
2018,2,74,"Purdue","Cal St. Fullerton",48,15,26,0,"Purdue-Cal St. Fullerton"
2018,3,70,"Texas Tech","Stephen F. Austin",60,14,10,0,"Texas Tech-Stephen F. Austin"
2018,4,75,"Wichita St.","Marshall",81,13,-6,0,"Wichita St.-Marshall"
2018,5,85,"West Virginia","Murray St.",68,12,17,0,"West Virginia-Murray St."
2018,6,77,"Florida","St. Bonaventure",62,11,15,0,"Florida-St. Bonaventure"
2018,7,62,"Arkansas","Butler",79,10,-17,0,"Arkansas-Butler"
2018,8,83,"Virginia Tech","Alabama",86,9,-3,0,"Virginia Tech-Alabama"
2018,1,76,"Kansas","Penn",60,16,16,0,"Kansas-Penn"
2018,2,89,"Duke","Iona",67,15,22,0,"Duke-Iona"
2018,3,82,"Michigan St.","Bucknell",78,14,4,0,"Michigan St.-Bucknell"
2018,4,62,"Auburn","College of Charleston",58,13,4,0,"Auburn-College of Charleston"
2018,5,79,"Clemson","New Mexico St.",68,12,11,0,"Clemson-New Mexico St."
2018,6,52,"TCU","Syracuse",57,11,-5,0,"TCU-Syracuse"
2018,7,83,"Rhode Island","Oklahoma",78,10,5,0,"Rhode Island-Oklahoma"
2018,8,94,"Seton Hall","North Carolina St.",83,9,11,0,"Seton Hall-North Carolina St."
2018,16,43,"UMBC","Kansas St.",50,9,-7,1,"UMBC-Kansas St."
2018,2,73,"Cincinnati","Nevada",75,7,-2,0,"Cincinnati-Nevada"
2018,3,62,"Tennessee","Loyola Chicago",63,11,-1,0,"Tennessee-Loyola Chicago"
2018,13,75,"Buffalo","Kentucky",95,5,-20,1,"Buffalo-Kentucky"
2018,1,70,"Xavier","Florida St.",75,9,-5,0,"Xavier-Florida St."
2018,2,65,"North Carolina","Texas A&M",86,7,-21,0,"North Carolina-Texas A&M"
2018,3,64,"Michigan","Houston",63,6,1,0,"Michigan-Houston"
2018,4,90,"Gonzaga","Ohio St.",84,5,6,0,"Gonzaga-Ohio St."
2018,1,81,"Villanova","Alabama",58,9,23,0,"Villanova-Alabama"
2018,2,76,"Purdue","Butler",73,10,3,0,"Purdue-Butler"
2018,3,69,"Texas Tech","Florida",66,6,3,0,"Texas Tech-Florida"
2018,13,71,"Marshall","West Virginia",94,5,-23,1,"Marshall-West Virginia"
2018,1,83,"Kansas","Seton Hall",79,8,4,0,"Kansas-Seton Hall"
2018,2,87,"Duke","Rhode Island",62,7,25,0,"Duke-Rhode Island"
2018,3,53,"Michigan St.","Syracuse",55,11,-2,0,"Michigan St.-Syracuse"
2018,4,53,"Auburn","Clemson",84,5,-31,0,"Auburn-Clemson"
2018,9,61,"Kansas St.","Kentucky",58,5,3,1,"Kansas St.-Kentucky"
2018,7,68,"Nevada","Loyola Chicago",69,11,-1,0,"Nevada-Loyola Chicago"
2018,9,75,"Florida St.","Gonzaga",60,4,15,1,"Florida St.-Gonzaga"
2018,7,72,"Texas A&M","Michigan",99,3,-27,1,"Texas A&M-Michigan"
2018,1,90,"Villanova","West Virginia",78,5,12,0,"Villanova-West Virginia"
2018,2,65,"Purdue","Texas Tech",78,3,-13,0,"Purdue-Texas Tech"
2018,1,80,"Kansas","Clemson",76,5,4,0,"Kansas-Clemson"
2018,2,69,"Duke","Syracuse",65,11,4,0,"Duke-Syracuse"
2018,9,62,"Kansas St.","Loyola Chicago",78,11,-16,0,"Kansas St.-Loyola Chicago"
2018,9,54,"Florida St.","Michigan",58,3,-4,1,"Florida St.-Michigan"
2018,1,71,"Villanova","Texas Tech",59,3,12,0,"Villanova-Texas Tech"
2018,1,85,"Kansas","Duke",81,2,4,0,"Kansas-Duke"
2018,11,57,"Loyola Chicago","Michigan",69,3,-12,1,"Loyola Chicago-Michigan"
2018,1,95,"Villanova","Kansas",79,1,16,0,"Villanova-Kansas"
2018,3,62,"Michigan","Villanova",79,1,-17,1,"Michigan-Villanova"
2019,1,85,"Duke","North Dakota St.",62,16,23,0,"Duke-North Dakota St."
2019,2,76,"Michigan St.","Bradley",65,15,11,0,"Michigan St.-Bradley"
2019,3,79,"LSU","Yale",74,14,5,0,"LSU-Yale"
2019,4,66,"Virginia Tech","Saint Louis",52,13,14,0,"Virginia Tech-Saint Louis"
2019,5,76,"Mississippi St.","Liberty",80,12,-4,0,"Mississippi St.-Liberty"
2019,6,79,"Maryland","Belmont",77,11,2,0,"Maryland-Belmont"
2019,7,76,"Louisville","Minnesota",86,10,-10,0,"Louisville-Minnesota"
2019,8,58,"VCU","UCF",73,9,-15,0,"VCU-UCF"
2019,1,87,"Gonzaga","Fairleigh Dickinson",49,16,38,0,"Gonzaga-Fairleigh Dickinson"
2019,2,74,"Michigan","Montana",55,15,19,0,"Michigan-Montana"
2019,3,72,"Texas Tech","Northern Kentucky",57,14,15,0,"Texas Tech-Northern Kentucky"
2019,4,76,"Florida St.","Vermont",69,13,7,0,"Florida St.-Vermont"
2019,5,64,"Marquette","Murray St.",83,12,-19,0,"Marquette-Murray St."
2019,6,91,"Buffalo","Arizona St.",74,11,17,0,"Buffalo-Arizona St."
2019,7,61,"Nevada","Florida",70,10,-9,0,"Nevada-Florida"
2019,8,69,"Syracuse","Baylor",78,9,-9,0,"Syracuse-Baylor"
2019,1,71,"Virginia","Gardner Webb",56,16,15,0,"Virginia-Gardner Webb"
2019,2,77,"Tennessee","Colgate",70,15,7,0,"Tennessee-Colgate"
2019,3,61,"Purdue","Old Dominion",48,14,13,0,"Purdue-Old Dominion"
2019,4,64,"Kansas St.","UC Irvine",70,13,-6,0,"Kansas St.-UC Irvine"
2019,5,54,"Wisconsin","Oregon",72,12,-18,0,"Wisconsin-Oregon"
2019,6,61,"Villanova","Saint Mary's",57,11,4,0,"Villanova-Saint Mary's"
2019,7,72,"Cincinnati","Iowa",79,10,-7,0,"Cincinnati-Iowa"
2019,8,72,"Mississippi","Oklahoma",95,9,-23,0,"Mississippi-Oklahoma"
2019,1,88,"North Carolina","Iona",73,16,15,0,"North Carolina-Iona"
2019,2,79,"Kentucky","Abilene Christian",44,15,35,0,"Kentucky-Abilene Christian"
2019,3,84,"Houston","Georgia St.",55,14,29,0,"Houston-Georgia St."
2019,4,87,"Kansas","Northeastern",53,13,34,0,"Kansas-Northeastern"
2019,5,78,"Auburn","New Mexico St.",77,12,1,0,"Auburn-New Mexico St."
2019,6,59,"Iowa St.","Ohio St.",62,11,-3,0,"Iowa St.-Ohio St."
2019,7,84,"Wofford","Seton Hall",68,10,16,0,"Wofford-Seton Hall"
2019,8,61,"Utah St.","Washington",78,9,-17,0,"Utah St.-Washington"
2019,1,77,"Duke","UCF",76,9,1,0,"Duke-UCF"
2019,2,70,"Michigan St.","Minnesota",50,10,20,0,"Michigan St.-Minnesota"
2019,3,69,"LSU","Maryland",67,6,2,0,"LSU-Maryland"
2019,4,67,"Virginia Tech","Liberty",58,12,9,0,"Virginia Tech-Liberty"
2019,1,83,"Gonzaga","Baylor",71,9,12,0,"Gonzaga-Baylor"
2019,2,64,"Michigan","Florida",49,10,15,0,"Michigan-Florida"
2019,3,78,"Texas Tech","Buffalo",58,6,20,0,"Texas Tech-Buffalo"
2019,4,90,"Florida St.","Murray St.",62,12,28,0,"Florida St.-Murray St."
2019,1,63,"Virginia","Oklahoma",51,9,12,0,"Virginia-Oklahoma"
2019,2,83,"Tennessee","Iowa",77,10,6,0,"Tennessee-Iowa"
2019,3,87,"Purdue","Villanova",61,6,26,0,"Purdue-Villanova"
2019,13,54,"UC Irvine","Oregon",73,12,-19,1,"UC Irvine-Oregon"
2019,1,81,"North Carolina","Washington",59,9,22,0,"North Carolina-Washington"
2019,2,62,"Kentucky","Wofford",56,7,6,0,"Kentucky-Wofford"
2019,3,74,"Houston","Ohio St.",59,11,15,0,"Houston-Ohio St."
2019,4,75,"Kansas","Auburn",89,5,-14,0,"Kansas-Auburn"
2019,1,75,"Duke","Virginia Tech",73,4,2,0,"Duke-Virginia Tech"
2019,2,80,"Michigan St.","LSU",63,3,17,0,"Michigan St.-LSU"
2019,1,72,"Gonzaga","Florida St.",58,4,14,0,"Gonzaga-Florida St."
2019,2,44,"Michigan","Texas Tech",63,3,-19,0,"Michigan-Texas Tech"
2019,1,53,"Virginia","Oregon",49,12,4,0,"Virginia-Oregon"
2019,2,94,"Tennessee","Purdue",99,3,-5,0,"Tennessee-Purdue"
2019,1,80,"North Carolina","Auburn",97,5,-17,0,"North Carolina-Auburn"
2019,2,62,"Kentucky","Houston",58,3,4,0,"Kentucky-Houston"
2019,1,67,"Duke","Michigan St.",68,2,-1,0,"Duke-Michigan St."
2019,1,69,"Gonzaga","Texas Tech",75,3,-6,0,"Gonzaga-Texas Tech"
2019,1,80,"Virginia","Purdue",75,3,5,0,"Virginia-Purdue"
2019,5,77,"Auburn","Kentucky",71,2,6,1,"Auburn-Kentucky"
2019,2,51,"Michigan St.","Texas Tech",61,3,-10,0,"Michigan St.-Texas Tech"
2019,1,63,"Virginia","Auburn",62,5,1,0,"Virginia-Auburn"
2019,3,77,"Texas Tech","Virginia",85,1,-8,1,"Texas Tech-Virginia"
2021,1,86,"Baylor","Gonzaga",70,1,16,0,"Baylor-Gonzaga"
2021,1,78,"Baylor","Houston",59,2,19,0,"Baylor-Houston"
2021,1,93,"Gonzaga","UCLA",90,11,3,0,"Gonzaga-UCLA"
2021,16,60,"Texas Southern","Mount St. Mary's",52,16,8,0,"Texas Southern-Mount St. Mary's"
2021,11,53,"Drake","Wichita St.",52,11,1,0,"Drake-Wichita St."
2021,16,54,"Norfolk St.","Appalachian St.",53,16,1,0,"Norfolk St.-Appalachian St."
2021,11,86,"UCLA","Michigan St.",80,11,6,0,"UCLA-Michigan St."
2021,7,75,"Florida","Virginia Tech",70,10,5,0,"Florida-Virginia Tech"
2021,3,85,"Arkansas","Colgate",68,14,17,0,"Arkansas-Colgate"
2021,1,78,"Illinois","Drexel",49,16,29,0,"Illinois-Drexel"
2021,6,65,"Texas Tech","Utah St.",53,11,12,0,"Texas Tech-Utah St."
2021,15,75,"Oral Roberts","Ohio St.",72,2,3,1,"Oral Roberts-Ohio St."
2021,1,79,"Baylor","Hartford",55,16,24,0,"Baylor-Hartford"
2021,8,71,"Loyola Chicago","Georgia Tech",60,9,11,0,"Loyola Chicago-Georgia Tech"
2021,12,70,"Oregon St.","Tennessee",56,5,14,1,"Oregon St.-Tennessee"
2021,4,69,"Oklahoma St.","Liberty",60,13,9,0,"Oklahoma St.-Liberty"
2021,9,85,"Wisconsin","North Carolina",62,8,23,1,"Wisconsin-North Carolina"
2021,2,87,"Houston","Cleveland St.",56,15,31,0,"Houston-Cleveland St."
2021,13,78,"North Texas","Purdue",69,4,9,1,"North Texas-Purdue"
2021,10,60,"Rutgers","Clemson",56,7,4,1,"Rutgers-Clemson"
2021,11,78,"Syracuse","San Diego St.",62,6,16,1,"Syracuse-San Diego St."
2021,3,84,"West Virginia","Morehead St.",67,14,17,0,"West Virginia-Morehead St."
2021,5,73,"Villanova","Winthrop",63,12,10,0,"Villanova-Winthrop"
2021,5,96,"Colorado","Georgetown",73,12,23,0,"Colorado-Georgetown"
2021,4,64,"Florida St.","UNC Greensboro",54,13,10,0,"Florida St.-UNC Greensboro"
2021,3,93,"Kansas","Eastern Washington",84,14,9,0,"Kansas-Eastern Washington"
2021,8,76,"LSU","St. Bonaventure",61,9,15,0,"LSU-St. Bonaventure"
2021,1,82,"Michigan","Texas Southern",66,16,16,0,"Michigan-Texas Southern"
2021,5,63,"Creighton","UC Santa Barbara",62,12,1,0,"Creighton-UC Santa Barbara"
2021,2,68,"Alabama","Iona",55,15,13,0,"Alabama-Iona"
2021,6,72,"USC","Drake",56,11,16,0,"USC-Drake"
2021,2,86,"Iowa","Grand Canyon",74,15,12,0,"Iowa-Grand Canyon"
2021,10,63,"Maryland","Connecticut",54,7,9,1,"Maryland-Connecticut"
2021,13,62,"Ohio","Virginia",58,4,4,1,"Ohio-Virginia"
2021,8,72,"Oklahoma","Missouri",68,9,4,0,"Oklahoma-Missouri"
2021,1,98,"Gonzaga","Norfolk St.",55,16,43,0,"Gonzaga-Norfolk St."
2021,11,73,"UCLA","BYU",62,6,11,1,"UCLA-BYU"
2021,14,53,"Abilene Christian","Texas",52,3,1,1,"Abilene Christian-Texas"
2021,7,NA,"Oregon","VCU",NA,10,NA,0,"Oregon-VCU"
2021,8,71,"Loyola Chicago","Illinois",58,1,13,1,"Loyola Chicago-Illinois"
2021,1,76,"Baylor","Wisconsin",63,9,13,0,"Baylor-Wisconsin"
2021,11,75,"Syracuse","West Virginia",72,3,3,1,"Syracuse-West Virginia"
2021,3,68,"Arkansas","Texas Tech",66,6,2,0,"Arkansas-Texas Tech"
2021,2,63,"Houston","Rutgers",60,10,3,0,"Houston-Rutgers"
2021,15,81,"Oral Roberts","Florida",78,7,3,1,"Oral Roberts-Florida"
2021,5,84,"Villanova","North Texas",61,13,23,0,"Villanova-North Texas"
2021,12,80,"Oregon St.","Oklahoma St.",70,4,10,1,"Oregon St.-Oklahoma St."
2021,7,95,"Oregon","Iowa",80,2,15,1,"Oregon-Iowa"
2021,1,87,"Gonzaga","Oklahoma",71,8,16,0,"Gonzaga-Oklahoma"
2021,11,67,"UCLA","Abilene Christian",47,14,20,0,"UCLA-Abilene Christian"
2021,5,72,"Creighton","Ohio",58,13,14,0,"Creighton-Ohio"
2021,1,86,"Michigan","LSU",78,8,8,0,"Michigan-LSU"
2021,4,71,"Florida St.","Colorado",53,5,18,0,"Florida St.-Colorado"
2021,2,96,"Alabama","Maryland",77,10,19,0,"Alabama-Maryland"
2021,6,85,"USC","Kansas",51,3,34,1,"USC-Kansas"
2021,12,65,"Oregon St.","Loyola Chicago",58,8,7,1,"Oregon St.-Loyola Chicago"
2021,1,62,"Baylor","Villanova",51,5,11,0,"Baylor-Villanova"
2021,3,72,"Arkansas","Oral Roberts",70,15,2,0,"Arkansas-Oral Roberts"
2021,2,62,"Houston","Syracuse",46,11,16,0,"Houston-Syracuse"
2021,1,83,"Gonzaga","Creighton",65,5,18,0,"Gonzaga-Creighton"
2021,1,76,"Michigan","Florida St.",58,4,18,0,"Michigan-Florida St."
2021,11,88,"UCLA","Alabama",78,2,10,1,"UCLA-Alabama"
2021,6,82,"USC","Oregon",68,7,14,0,"USC-Oregon"
2021,2,67,"Houston","Oregon St.",61,12,6,0,"Houston-Oregon St."
2021,1,81,"Baylor","Arkansas",72,3,9,0,"Baylor-Arkansas"
2021,1,85,"Gonzaga","USC",66,6,19,0,"Gonzaga-USC"
2021,11,51,"UCLA","Michigan",49,1,2,1,"UCLA-Michigan"
